1111111111
1000000111
1011010111
1000010001
1111120001
1000001101
1000000101
1011120101
1000110001
1111111111

