1111111111
1000100101
1110100101
1000100101
1011100001
1000001001
1111110001
1110010011
1110000011
1111111111

