1111111111
1000001001
1116101001
1000100001
1000000011
2000000311
1110111111
1000000001
2000010003
1111111111

