1111111111
1000000011
1000000001
1001111001
1101001001
1001011001
1001000001
1131011121
1000000001
1111111111

