1111111111
1000011111
1111011161
1111011001
1000031001
1000011001
1011111001
1011100001
4000001001
1111111111

