1111116111
1011100001
1011200103
1010000401
1010111103
1000111401
1110000103
1111200101
1111100001
1111115111

