1111111111
1010000031
1010101011
1000100031
1111101111
1400000011
1102000011
1400011111
1111000011
1111111111

