1111111111
1000010001
1110000031
1110100001
1110001001
1111111001
1000000011
1011031111
4000011111
1111111111

