1111111111
1000011111
1611011111
1040002001
1000100001
1000000011
1006021501
1000040001
1100000301
1121111111

