1111111111
1000000001
1000000001
1000121001
1121100001
1000100111
1000500001
1100110001
1000000301
1111111111

