1111111111
1000110001
1100000201
1000000001
1000001111
1111000001
1000000001
1020000011
1000110001
1111111111

